TILEMAP
72 28 							-- Size of tile map in tiles
16 32 							-- Tile size & block size
images/blocks.png 	-- Tilesheet
2 2 								-- Number of tiles in tilesheet
111111111111111111111111111111111111111111111111111111111111111111111111
11                                                                    11
11                                                                    11
11                                                                    11
11                                                                    11
11                                                                    11
11                                                                    11
1111   11111   1   1   111111   11111111   11111   1   1   111111   1111
11           1 1 1 1 1                           1 1 1 1 1            11
11                                                                    11
11                                                                    11
11                                                                    11
1111   1111   33   44   11111   11111111   1111   33   44   11111   1111
11                                                                    11
11                                                                    11
11              111               1111              111               11
11                                                                    11
1111   111  22       22  1111   11111111   111  22       22  1111   1111
11            22   22                             22   22             11
11             22222                               22222              11
11                                                                    11
11                                                                    11
1111                            11111111   1111111111111111111111   1111
11                                                                    11
11                                                                    11
11                                                                    11
11        1                                                           11
111111111111111111111111111111111111111111111111111111111111111111111111
OBJECTS
Stone                              -- Object name
4 16                              -- Number of objects & object size
images/blocks.png       -- Tilesheet
4 4				--Tilesheet Size
2 2                               -- Tile position
10 25 
15 25 
15 26 
15 24 
END                                 -- Objects end